4 4 4 4 4 4 4 4 4 4 4 4 4 4 4 4 4 4 4 4 4 4 4 4 4 4 4 4 4 4 4 4 4 4 4 4 4 4 4 4 4 4 4 4 4 4 4 4 4 4 
4 4 4 4 4 4 4 4 4 4 4 4 4 4 4 4 4 4 4 4 4 4 4 4 4 4 4 4 4 4 4 4 4 4 4 4 4 4 4 4 4 4 4 4 4 4 4 4 4 4 
4 4 4 4 4 4 4 4 4 4 4 4 4 4 4 4 4 4 4 4 4 4 4 4 4 4 4 4 4 4 4 4 4 4 4 4 4 4 4 4 4 4 4 4 4 4 4 4 4 4 
4 4 4 4 4 4 4 4 4 4 4 4 4 4 4 4 4 4 4 4 4 4 4 4 4 4 4 4 4 4 4 4 4 4 4 4 4 4 4 4 4 4 4 4 4 4 4 4 4 4 
4 4 4 4 3 3 3 3 3 3 3 3 4 4 4 4 4 4 4 4 4 4 4 4 4 4 4 4 4 4 4 4 4 4 4 4 4 4 4 4 4 4 4 4 4 4 4 4 4 4 
3 3 3 3 3 3 3 3 3 3 3 3 3 3 3 3 3 3 3 3 3 3 3 3 3 3 3 3 3 3 3 3 3 3 3 3 3 3 3 3 3 3 3 3 3 3 3 3 3 3 
3 3 3 3 3 3 3 3 3 3 3 3 3 3 3 3 3 3 3 3 3 3 3 3 3 3 3 3 3 3 3 3 3 3 3 3 3 3 3 3 3 3 3 3 3 3 3 3 3 3 
3 3 3 3 3 3 3 3 3 3 3 3 3 3 3 3 3 3 3 3 3 3 3 3 3 3 3 3 3 3 3 3 3 3 3 3 3 3 3 3 3 3 3 3 3 3 3 3 3 3 
3 3 3 3 3 3 3 3 3 3 3 3 3 3 3 3 3 3 3 3 3 3 3 3 3 3 3 3 3 3 3 3 3 3 3 3 3 3 3 3 3 3 3 3 3 3 3 3 3 3 
3 3 3 3 3 3 3 3 3 3 3 3 3 3 3 3 3 3 3 3 3 3 3 3 3 3 3 3 3 3 3 3 3 3 3 3 3 3 3 3 3 3 3 3 3 3 3 3 3 3 
2 2 2 2 2 2 2 2 2 2 2 2 2 2 2 2 2 2 13 13 13 13 13 13 13 13 13 13 13 13 13 13 13 13 13 3 3 3 3 3 3 3 3 3 3 3 3 3 3 3 
2 2 2 2 2 2 2 2 2 2 2 2 2 2 2 2 2 2 13 3 3 3 3 3 3 3 3 3 3 3 3 3 3 3 13 13 13 13 13 13 13 13 13 13 13 13 13 13 16 16 
2 2 2 2 2 2 2 2 2 2 2 2 2 2 2 2 2 2 13 3 3 3 12 12 12 12 12 12 12 12 12 3 3 3 13 15 15 15 15 15 15 15 15 15 15 15 15 13 16 16 
2 2 2 2 2 2 2 2 2 2 2 2 2 2 2 2 2 2 2 3 3 3 10 4 4 4 4 4 4 4 11 3 3 3 13 15 2 2 2 2 2 2 2 2 2 2 15 13 16 16 
2 2 2 2 2 2 2 2 2 2 2 2 2 2 2 2 2 2 13 3 3 3 10 4 4 4 4 4 4 4 11 3 3 3 13 15 2 2 2 2 2 2 2 2 2 2 15 13 16 16 
2 2 2 2 2 2 2 2 2 2 2 2 2 2 2 2 2 2 13 3 3 3 10 4 4 4 4 4 4 4 11 3 3 3 13 15 2 2 2 2 2 2 2 2 2 2 15 13 16 16 
2 2 2 2 2 2 2 2 2 2 2 2 2 2 2 2 2 2 13 3 3 3 10 4 4 4 4 4 4 4 11 3 3 3 13 15 2 2 2 2 2 2 2 2 2 2 15 13 16 16 
2 2 2 2 2 2 2 2 2 2 2 2 2 2 2 2 2 2 13 3 3 3 9 9 9 9 9 9 9 9 9 3 3 3 13 15 2 2 2 2 2 2 2 2 2 2 15 13 16 16 
2 2 2 2 2 2 2 2 2 2 2 2 2 2 2 2 2 2 13 3 3 3 3 3 3 3 3 3 3 3 3 3 3 3 13 15 2 2 2 2 2 2 2 2 2 2 15 13 16 16 
2 2 2 2 2 2 2 2 2 2 2 2 2 2 2 2 2 2 13 13 3 3 3 3 3 3 3 3 3 3 3 3 3 3 13 15 15 15 15 15 15 15 2 15 15 15 15 13 16 16 
2 2 2 2 2 2 2 2 2 2 2 2 2 2 2 2 2 2 2 13 13 13 13 13 13 13 13 13 13 13 13 13 13 13 13 13 13 13 13 13 13 13 13 13 13 13 13 13 13 13 
2 2 2 2 2 2 2 2 2 2 2 2 2 2 2 2 2 2 2 2 13 13 13 13 13 13 13 13 2 2 2 2 2 2 2 2 2 2 2 2 2 2 2 2 2 2 2 2 2 2 
2 2 2 2 2 2 2 2 2 2 2 13 13 2 2 2 2 2 2 2 16 16 16 16 16 16 13 13 2 2 2 2 2 2 16 16 16 16 16 16 16 16 16 16 16 16 16 16 16 16 
16 16 16 16 16 16 16 16 16 16 16 13 13 16 16 16 16 16 16 16 16 16 16 16 16 16 13 13 2 2 2 2 2 2 16 16 16 16 16 16 16 16 16 16 16 16 16 16 16 16 
16 16 16 16 16 16 16 16 16 16 16 13 13 16 16 16 16 16 16 16 16 16 16 16 16 16 13 13 2 2 2 2 2 2 16 16 16 16 16 16 16 16 16 16 16 16 16 16 16 16 
16 16 16 16 16 16 16 16 16 16 16 13 13 16 16 16 16 16 16 16 16 16 16 16 16 16 13 13 2 2 2 2 2 2 14 14 14 14 14 14 14 14 14 14 14 14 14 14 16 16 
16 16 16 16 16 16 16 16 16 16 16 13 13 16 16 16 16 16 16 16 16 16 16 16 16 16 13 13 2 2 2 2 2 2 14 14 14 14 14 14 14 14 14 14 14 14 14 14 16 16 
13 13 13 13 13 13 13 13 13 13 13 13 13 13 13 13 13 13 13 13 13 13 13 13 13 13 13 13 2 2 2 2 2 2 14 14 14 14 14 14 14 14 14 14 14 14 14 14 16 16 
13 13 13 13 13 13 13 13 13 13 13 13 13 13 13 13 13 13 13 13 13 13 13 13 13 13 13 13 2 2 2 2 2 2 14 14 14 14 14 14 14 14 14 14 14 14 14 14 16 16 
14 14 14 14 14 13 13 13 14 14 14 14 16 16 16 16 16 16 16 16 16 16 16 16 16 16 13 13 2 2 2 2 2 2 14 14 14 14 14 14 14 14 14 14 14 14 14 14 16 16 
14 14 14 3 3 3 3 3 3 3 3 14 16 16 16 16 16 16 16 16 16 16 16 16 16 16 13 13 2 2 2 2 2 2 14 14 14 14 14 14 14 2 2 2 14 14 14 14 16 16 
14 3 3 3 3 3 3 3 3 3 3 14 16 16 16 16 16 16 16 16 16 16 16 16 16 16 13 13 2 2 2 2 2 2 2 2 2 2 2 2 2 2 2 2 2 2 2 2 2 2 
14 3 3 3 3 3 3 3 3 3 3 14 16 16 16 16 16 16 16 16 16 16 16 16 16 16 13 13 2 2 2 2 2 2 2 2 2 2 2 2 2 2 2 2 2 2 2 2 2 2 
14 3 3 3 3 3 3 3 3 3 3 14 16 16 16 16 16 16 16 16 16 16 16 16 16 16 13 13 2 2 2 2 2 2 2 2 2 2 2 2 2 2 2 2 2 2 2 2 2 2 
14 3 3 3 3 3 3 3 3 3 3 14 16 16 16 16 16 16 16 16 16 16 16 16 16 16 13 13 2 2 2 2 2 2 2 2 2 2 2 2 2 2 2 2 2 2 2 2 2 2 
14 3 3 3 3 3 3 3 3 3 3 14 16 16 16 16 16 16 16 16 16 16 16 16 16 16 13 13 2 2 2 2 2 2 2 2 2 2 2 2 2 2 2 2 2 2 2 2 2 2 
14 3 3 3 3 3 3 3 3 3 3 13 13 13 13 13 13 13 13 13 13 13 13 13 13 13 13 13 2 2 2 2 2 2 2 2 2 2 2 2 2 2 2 2 2 2 2 2 2 2 
14 3 3 3 3 3 3 3 3 3 3 13 13 13 13 13 13 13 13 13 13 13 13 13 13 13 13 13 2 2 2 2 2 2 2 2 2 2 2 2 2 2 2 2 2 2 2 2 2 2 
14 3 3 3 3 3 3 3 3 3 3 3 3 14 16 16 16 16 16 16 16 16 16 16 16 16 13 13 13 13 13 13 13 13 13 12 12 12 12 12 12 12 12 12 12 12 12 12 11 16 
14 3 3 3 3 3 3 3 3 3 3 3 3 14 16 16 16 16 16 16 16 16 16 16 16 16 13 13 13 13 13 13 13 13 13 10 15 15 15 15 15 15 15 15 15 15 15 15 11 16 
14 3 3 3 3 3 3 3 3 3 3 3 3 14 16 16 16 16 16 16 16 16 16 16 16 16 13 13 13 13 13 13 13 13 13 10 15 15 15 15 15 15 15 15 15 15 15 15 11 16 
14 3 3 3 3 3 3 3 3 3 3 3 3 14 16 16 16 16 16 16 16 16 16 16 16 16 13 13 13 13 13 13 13 13 13 10 15 2 2 2 2 2 2 2 2 2 2 15 11 16 
14 3 3 3 3 3 3 3 3 3 3 3 3 14 16 16 16 16 16 16 16 16 16 16 16 16 13 13 13 13 13 13 13 13 13 10 15 2 2 2 2 2 2 2 2 2 2 15 11 16 
14 3 3 3 3 3 3 3 3 3 3 3 3 14 16 16 16 16 16 16 16 16 16 16 16 16 13 13 13 13 13 13 13 13 13 10 15 2 2 2 2 2 2 2 2 2 2 15 11 16 
14 3 3 3 3 3 3 3 3 3 3 3 3 14 16 16 16 16 16 16 16 16 16 16 16 16 13 13 13 13 13 13 13 13 13 10 15 2 2 2 2 2 2 2 2 2 2 15 11 16 
14 14 3 3 3 3 3 3 3 3 3 3 3 14 16 16 16 16 16 16 16 16 16 16 13 13 13 13 13 13 13 13 13 13 13 10 15 2 2 2 2 2 2 2 2 2 2 15 11 16 
14 14 3 3 3 3 3 3 3 3 3 3 3 13 13 13 13 13 13 13 13 13 13 13 13 13 13 13 13 13 13 13 13 13 13 10 15 2 2 2 2 2 2 2 2 2 2 15 11 16 
14 3 3 3 3 3 3 3 3 3 3 3 3 13 13 13 13 13 13 13 13 13 13 13 13 13 13 13 13 13 13 13 13 13 13 10 15 15 15 15 15 15 2 15 15 15 15 15 11 16 
14 4 3 3 3 3 3 3 3 3 3 3 3 14 14 16 16 16 16 16 16 16 16 16 16 13 13 13 13 13 13 13 13 13 13 13 13 13 13 13 13 13 13 13 13 13 13 13 13 16 
14 14 14 14 14 14 14 14 14 14 14 14 14 14 14 16 16 16 16 16 16 16 16 16 16 13 13 13 13 13 13 13 13 13 13 13 13 13 13 13 13 13 13 13 13 13 13 13 13 16 
